                            ------------------------
                            |..^^^^^^^^^^^^^^^^^^..|
                            |..-------------------.|
                          ----.|    -----        |.|
                          |..|O--  --...|        |.|
                          |.....|--|.O..|        |.|
                          |.OO..|..|.OO.|        |.|
                          --..OO|O.....--        |.|
                           |O..O..@|O..|   ------|.|
                           |.OOO|O.|..O| --|.....|.|
                           |.O.O---|.O.| |.+.....|.|
                           |.....O.|..-- |-|.....|.|
                           ----.O..|.--  |.+.....+.|
                              ---.--.|   |-|.....|--
                               |.....|   |.+.....|
                               |>....|   --|.....|
                               -------     -------
