.                            ------------------------
.                            |..^^^^^^^^^^^^^^^^^^..|
.                            |..-------------------.|
.                          ----.|    -----        |.|
.                          |..|`--  --...|        |.|
.                          |.....|--|.`..|        |.|
.                          |.``..|..|..`.|        |.|
.                          --..``|...``.--        |.|
.                           |`..`...|`..|   ------|.|
.                           |.``.|..|..`| --|.....|.|
.                           |.`.`---|.`.| |.+.....|.|
.                           |.......|..-- |-|.....|.|
.                           ----.`..|.--  |.+.....+.|
.                              ---.--.|   |-|.....|--
.                               |.`...|   |.+.....|
.                               |@.|..|   --|.....|
.                               -------     -------
